111111111111111111111111
1EC000000000000000000001
1010100100100C0010011111
10001CC0000000000C011001
101110C00C00C0000C000001
1000100100100C0000110001
1010100010101010000100P1
111111111111111111111111