11111111111111111111111111111
1E1000000000000C0000100000001
10101001001000001010001111111
10101001001010100000000000001
10001000000000000001111111001
11111000000000000001000001001
1E0010000000000C0001010001001
11101001001000001011010001001
10101000101010100000011111111
100000000000000000000000000P1
11111111111111111111111111111