111111111111111111111111
1EC000000000000000000001
101010010010000010011111
100010000000000000110001
101110000000000000000001
100010010010000000110001
1010100010101010000100P1
111111111111111111111111